############################
#............##............#
#.####.#####.##.#####.####.#
#*####.#####.##.#####.####*#
#.####.#####.##.#####.####.#
#..........................#
#.####.##.########.##.####.#
#......##....##....##......#
######.##### ## #####.######
     #.##### ## #####.#     
     #.##          ##.#     
     #.##  ##__##  ##.#     
######.##  #    #  ##.######
      .    #    #    .      
######.##  #    #  ##.######
     #.##  ######  ##.#     
######.## ######## ##.######
#............##............#
#.####.#####.##.#####.####.#
#.####.#####.##.#####.####.#
#*..##................##..*#
###.##.##.########.##.##.###
###.##.##.########.##.##.###
#......##....##....##......#
#.##########.##.##########.#
#.##########.##.##########.#
#..........................#
############################
